# Syntax Coloring Map for BERGCloud CC3000 Library

# Datatypes (KEYWORD1)
BERGCloud	KEYWORD1
BERGCloudWLANConfig	KEYWORD1
BERGCloudCC3000	KEYWORD1

# Methods and Functions (KEYWORD2)
begin	KEYWORD2
end	KEYWORD2
pollForCommand	KEYWORD2
sendEvent	KEYWORD2
getDeviceAddress	KEYWORD2
connect	KEYWORD2
getClaimcode	KEYWORD2
resetClaimcode	KEYWORD2
getClaimingState	KEYWORD2
getConnectionState	KEYWORD2

# Constants (LITERAL1)
BC_EUI64_SIZE_BYTES	LITERAL1
BC_ADDRESS_SIZE_BYTES	LITERAL1
BC_CLAIMCODE_SIZE_BYTES	LITERAL1
BC_KEY_SIZE_BYTES	LITERAL1
BC_DEVICE_ADDRESS_SIZE_BYTES	LITERAL1
BC_CLAIM_STATE_CLAIMED	LITERAL1
BC_CLAIM_STATE_NOT_CLAIMED	LITERAL1
BC_CONNECT_STATE_CONNECTED	LITERAL1
BC_CONNECT_STATE_CONNECTING	LITERAL1
BC_CONNECT_STATE_DISCONNECTED	LITERAL1


# Syntax Coloring Map for BERGCloudMessage

# Datatypes (KEYWORD1)
BERGCloudMessage	KEYWORD1

# Methods and Functions (KEYWORD2)
pack	KEYWORD2
pack_nil	KEYWORD2
pack_array	KEYWORD2
pack_map	KEYWORD2
pack_boolean	KEYWORD2
unpack	KEYWORD2
unpack_nil	KEYWORD2
unpack_array	KEYWORD2
unpack_map	KEYWORD2
unpack_boolean	KEYWORD2
unpack_peek	KEYWORD2
print	KEYWORD2
print_bytes	KEYWORD2
unpack_skip	KEYWORD2
unpack_restart	KEYWORD2
unpack_find	KEYWORD2

# Constants (LITERAL1)